---------
-21 ED - 
-     C- 
-      - 
-  *   / 
-V     - 
- P   L- 
---------